000000000000fffffffff0000000000000000000
0000000000011111111111111110000000000000
0000000000000000111111111110000000000000
0000000000000000111111111110000000000000
0000000000000000111111111110000000000000
0000000000000000111111111111110000000000
0000000000000000111111111111110000000000
0000000000000000000011111111110000000000
0000000000000000000011111111110000000000
0000000000000000000011111111110000000000
0000000000000000000011111111110000000000
0000000000000000000011111111111110000000
0000000000000000000011111111111111111100
0000000000000000000000011111111111111000
0000000000000000000000011111111111111000
0000000000000000000000000011111111111000
0000000000000000000000000011111111111000
0011111111111111111000000011111111111000
0011111111111111111100000011111111111000
0011111111111111111100000011111111111000
0001111100000011111111100011111111111000
0011111000000111111111000011111111111000
0011111000001111111111111111111111111000
1111110000000011111111111111111111111000
1111110000000000000000000000000000000000
1111110000000000000000000000000000000000
1111110000000000000000000000000000000000
1111110000000000000000000000000000000000
1111110000000000000000000000000000000000
11s1110000000000000000000000000000000000