0000000000000000000000000000000000000000
0000000000000000000000000000000000000000
0000000000000000000000000000000000000000
0000000000000000000000000000000000000000
0000000000000000000000000000000000000000
0000000000000000000000000000000000000000
0000000000000000000000000000000000000000
0000000000000000000000000000000000000000
000000000000000000000001111111111111111f
000000000000000000000001111111111111111f
000000000000011111111111111111111111111f
000000000000011111111111111111111111111f
000000000000011111111111111111111111111f
0000000000000111111111111111100000000000
0000000000000111111111111111100000000000
0000000000000111111111111111100000000000
0000000000000111111111111111100000000000
0000000011111111111111111111100000000000
0000000011111111111111100000000000000000
0000000011111111111111100000000000000000
0000000011111111111111100000000000000000
0000000011111111111111111111100000000000
0000000011111111111111111111100000000000
0000000011111111111111111111111111111110
0000000000000000000011111111111111111110
000000000000000000001111111111111111111s
0000000000000000000000000000011111111110
0000000000000000000000000000011111111110
0000000000000000000000000000000000000000
0000000000000000000000000000000000000000