0000000000000000000000000000000000000000
0000000000000000000000000000000000000000
0000000000000000000000000000000000000000
0000000000000000000000000000000000000000
0000000000000000000000000000000000000000
0000000000000000000000000000000000000000
0000000000000000000000000000000000000000
f111100000000000000000000000000000000000
f111100000000000000000000000000000000000
f111111111111000000000000000000000000000
f111111111111000000000000000000000000000
f111111111111000000000000000000000000000
f111111111111111000000000000000000000000
000011111111111100000000001111111111111f
000011111111111100000000001111111111111f
000011111111111100000000001111111111111f
000011111111111100000000001111111111111f
0000000001111111100000000001111111000000
0000000001111111100000000001111111000000
0000000001111111100000000001111111000000
0000000001111111100000000001111111000000
0111111111111111111000000001111111000000
0111111111111111111111111111111111000000
s111111111111111111111111111111111000000
0111111111111111111111111111111111000000
0000000000000000000000000000000000000000
0000000000000000000000000000000000000000
0000000000000000000000000000000000000000
0000000000000000000000000000000000000000
0000000000000000000000000000000000000000