00000ffffffffffffffffffffffffffffff00000
0000011111111111111111111111111111100000
0000011111111111111111111111111111100000
0000000110111100000000000111111111100000
0000000110111100000000000111111111100000
0000000110111100000000000111111111100000
0000011111111111111111111111111111100000
0000011111111111111111111111111111100000
0000011111111111111111111111111111100000
0000011111111111110000000000000000000000
0000011111111111110000000000000000000000
0000011111111111110000000000000000000000
0000011111111111111111111111111111100000
0000011111111111111111111111111111100000
0000011111111111111111111111111111100000
0000011111111111111111111111111111100000
0000000000000000000000000000001111100000
0000000000000000000000000000001111100000
0000000000000000000000000000001111100000
0000011111111111111111111111111111100000
0000011111111111111111111111111111100000
0000011111111111111111111111111111100000
0000011111111111111111111111111111100000
0000011111100000011111111111110000000000
0000011111111111111111111111111111100000
0000011111111111111111111111111111100000
0000011111111111111111111111111111100000
0000011111111111111111111100001111100000
0000011111111111111111111111111111100000
0000011111111111111s11111111111111100000