0000000000000000000000000000000000000000
0000000000000000000000000000000000000000
0000000000000000000000000000000000000000
0000000000000000000000000000000000000000
0000000000000000000000000000000000000000
0000000000000000000000000000000000000000
0000000000000011111111110000000000000000
0000000000000011111111111111100000000000
0000000000000011111111111111100000000000
0000000001111111111111111111100000000000
0000000001111111111111111111100000000000
0000000001111111000000111111111111000000
0000000001111111000000111111111111000000
0000000001111111000000000001111111000000
0000000001111111000000000001111111000000
00000f1111111111000000000001111111000000
00000f1111111f00000000000001111111111100
00000f1111111f00000000000000111111110000
00000f1111111f00000000000000111111110000
00000fffffffff00000000000000111111110000
0000000000000000000000000000111111110000
0000000000000000000000000000111111110000
0000000000000000011111111111111111110000
0000000000000000011111111111111000000000
0000000000000000s11111111111111000000000
0000000000000000011111111111111000000000
0000000000000000011111111111111000000000
0000000000000000011111111111111000000000
0000000000000000000000000000000000000000
0000000000000000000000000000000000000000