00000ffffffffffffffffffffffffffffff0000000000ffffffffffffffffffffffffffffff00000
00000111111111111111111111111111111000000000011111111111111111111111111111100000
00000111111111111111111111111111111000000000011111111111111111111111111111100000
00000001101111000000000001111111111000000000000110111100000000000111111111100000
00000001101111000000000001111111111000000000000110111100000000000111111111100000
00000001101111000000000001111111111000000000000110111100000000000111111111100000
00000111111111111111111111111111111000000000011111111111111111111111111111100000
00000111111111111111111111111111111000000000011111111111111111111111111111100000
00000111111111111111111111111111111000000000011111111111111111111111111111100000
00000111111111111100000000000000000000000000011111111111110000000000000000000000
00000111111111111100000000000000000000000000011111111111110000000000000000000000
00000111111111111100000000000000000000000000011111111111110000000000000000000000
00000111111111111111111111111111111000000000011111111111111111111111111111100000
00000111111111111111111111111111111000000000011111111111111111111111111111100000
00000111111111111111111111111111111000000000011111111111111111111111111111100000
00000111111111111111111111111111111000000000011111111111111111111111111111100000
00000000000000000000000000000011111000000000000000000000000000000000001111100000
00000000000000000000000000000011111000000000000000000000000000000000001111100000
00000000000000000000000000000011111000000000000000000000000000000000001111100000
00000111111111111111111111111111111000000000011111111111111111111111111111100000
00000111111111111111111111111111111000000000011111111111111111111111111111100000
00000111111111111111111111111111111000000000011111111111111111111111111111100000
00000111111111111111111111111111111000000000011111111111111111111111111111100000
00000111111000000111111111111100000000000000011111100000011111111111110000000000
00000111111111111111111111111111111000000000011111111111111111111111111111100000
00000111111111111111111111111111111000000000011111111111111111111111111111100000
00000111111111111111111111111111111000000000011111111111111111111111111111100000
00000111111111111111111111000011111000000000011111111111111111111100001111100000
00000111111111111111111111111111111000000000011111111111111111111111111111100000
0000011111111111111s111111111111111000000000011111111111111s11111111111111100000
00000ffffffffffffffffffffffffffffff0000000000ffffffffffffffffffffffffffffff00000
00000111111111111111111111111111111000000000011111111111111111111111111111100000
00000111111111111111111111111111111000000000011111111111111111111111111111100000
00000001101111000000000001111111111000000000000110111100000000000111111111100000
00000001101111000000000001111111111000000000000110111100000000000111111111100000
00000001101111000000000001111111111000000000000110111100000000000111111111100000
00000111111111111111111111111111111000000000011111111111111111111111111111100000
00000111111111111111111111111111111000000000011111111111111111111111111111100000
00000111111111111111111111111111111000000000011111111111111111111111111111100000
00000111111111111100000000000000000000000000011111111111110000000000000000000000
00000111111111111100000000000000000000000000011111111111110000000000000000000000
00000111111111111100000000000000000000000000011111111111110000000000000000000000
00000111111111111111111111111111111000000000011111111111111111111111111111100000
00000111111111111111111111111111111000000000011111111111111111111111111111100000
00000111111111111111111111111111111000000000011111111111111111111111111111100000
00000111111111111111111111111111111000000000011111111111111111111111111111100000
00000000000000000000000000000011111000000000000000000000000000000000001111100000
00000000000000000000000000000011111000000000000000000000000000000000001111100000
00000000000000000000000000000011111000000000000000000000000000000000001111100000
00000111111111111111111111111111111000000000011111111111111111111111111111100000
00000111111111111111111111111111111000000000011111111111111111111111111111100000
00000111111111111111111111111111111000000000011111111111111111111111111111100000
00000111111111111111111111111111111000000000011111111111111111111111111111100000
00000111111000000111111111111100000000000000011111100000011111111111110000000000
00000111111111111111111111111111111000000000011111111111111111111111111111100000
00000111111111111111111111111111111000000000011111111111111111111111111111100000
00000111111111111111111111111111111000000000011111111111111111111111111111100000
00000111111111111111111111000011111000000000011111111111111111111100001111100000
00000111111111111111111111111111111000000000011111111111111111111111111111100000
0000011111111111111s111111111111111000000000011111111111111s11111111111111100000