0000000000000000000000000000000000000000
0000000000000000000000000000000000000000
0000000000000000000000000000000000000000
0000000000000000000000000000000000000000
0000000000000000000000000000000000000000
0000000000000000000111111000000000000000
0000000000000000011111111100000000000000
0000000000000001111111111110000000000000
0000000000000111111111111111000000000000
0000000011111111110000111111111100000000
0000000001111111000000011111111110000000
0000001111111100000001111111110000000000
0000011111111000000011111100000000000000
0000111111111000000000111111111000000000
0011111111100000000000001111000000000000
0001111111100000000000111111111111000000
0011111111000000000000011111111100000000
0011111110000000000001111111111111100000
0011111110000000000000011111111110000000
0011111110000000000000011111111110000000
0001111111000000000000011111111110000000
0011111110000000000000011111111110000000
0011111110000000000000011111111110000000
0001111110000000000000011111111110000000
0011111110000000000000011111111110000000
0001111110000000000000011111111110000000
0000111111000000000000011111111110000000
0001111110000000000000011111111110000000
0001111111000000000000011111111110000000
000000s000000000000000000000f00000000000