00ffffffff00
000000110000
001111111100
001111111100
000011111000
001111111100
000000011100
001111111100
00000s000000