0000000000000011111110000000000000000000
0000000000011111110000000000000000000000
0000000000000000000000000000000000000000
0000000000000000000000000000000000000000
0000000000000000000000000000000000000000
0000000000000000000000000000000000000000
0000000000000000000000000000000000000000
0000000000000000000000000000000000000000
0000000000000000000000000000000000000000
0000000000000000000000000000000000000000
0000000000000000000000000000000000000000
0000000000000000000000000000000000000000
0000000000000000000000000000000000000000
0000000000000000000000000000000000000000
0000000000000000000000000000000000000000
0000000000000000000000000000000000000000
0000000000000000000000000000000000000000
0000000000000000000000000000000000000000
0000000000000000000000000000000000000000
0000000000000000000000000000000000000000
0000000000000000000000000000000000000000
0000000000111111100000000000000000000000
0000000111111111110000000000000000000000
0000000011111111111111000000000000000000
0000011111111000000000000000000000000000
0011111111000000000000000000000000000000
0000111111000000000000000000000000000000
0011111000000000000000000000000000000000
1111110000000000000000000000000000000000
11s1110000000000000000000000000000000000